1111111111
1200000021
1010001001
1000000001
1010051001
1000000001
1050000001
1000000001
1200000021
1111111111